caudate	BasalGanglia
putamen	BasalGanglia
pallidum	BasalGanglia
hippocampus	Temporal
amygdala	Temporal
bankssts	Temporal
caudalanteriorcingulate	Frontal
caudalmiddlefrontal	Frontal
cuneus	Occipital
entorhinal	Temporal
fusiform	Temporal
inferiorparietal	Parietal
inferiortemporal	Temporal
isthmuscingulate	Parietal
lateraloccipital	Occipital
lateralorbitofrontal	Frontal
lingual	Occipital
medialorbitofrontal	Frontal
middletemporal	Temporal
parahippocampal	Temporal
paracentral	Frontal
parsopercularis	Frontal
parsorbitalis	Frontal
parstriangularis	Frontal
pericalcarine	Occipital
postcentral	Parietal
posteriorcingulate	Parietal
precentral	Frontal
precuneus	Parietal
rostralanteriorcingulate	Frontal
rostralmiddlefrontal	Frontal
superiorfrontal	Frontal
superiorparietal	Parietal
superiortemporal	Temporal
supramarginal	Parietal
frontalpole	Frontal
temporalpole	Temporal
transversetemporal	Temporal
insula	Temporal
